.1,.1,.1,.1,.1,.1,.1,.1,.1
.2,.2,.2,.2,.2,.2,.2,.2,.2
.3,.3,.3,.3,.3,.3,.3,.3,.3
.4,.4,.4,.4,.4,.4,.4,.4,.4
.9,.9,.7,.3,.9,.3,.7,.9,.9
.0,.0,.0,.0,.0,.0,.0,.0,.0
.5,.0,.0,.0,.0,.0,.0,.0,.5
.0,.0,.0,.0,.0,.0,.0,.0,.0
.9,.2,.9,.9,.9,.9,.9,.2,.9
.4,.4,.4,.4,.4,.4,.4,.4,.4
.3,.3,.3,.3,.3,.3,.3,.3,.3
.2,.2,.2,.2,.2,.2,.2,.2,.2
.1,.1,.1,.1,.1,.1,.1,.1,.1
